9113D11513
AC2A92C16A
812C001412
86C12AA942
8114404292
AAAD169042
8443C54412
8152D55542
82FA93FFFA
C2FC4057FA
92FFFAFFFA
AC53FAFD52
A952FAFFFA
86BC12D112
8101441282
A80411682A
8281281286
AC2C068403
814141412A
C454545446

1, 1
9, 9
ESSEESEEESEESSSS
